a g a a a a a a a a a a a a a a a g a a a a a a a a a a a a a a a g a a a a a a a a a a a a a a a a
a t t t t t t t t t t t t t t t t t t t t t t t t t t t t t t t t t t t t t t t t t t t t t t t t a
a t t t t t t t t t t t t t t t t t t t t t t t t t t t t t t t t t t t t t t t t t t t t t t t t a
a t t t t t t t t t w w w w w t t t t t t t t t t t t t t t t t t t t t t t t t t t t t t t t t t a
a t t t t t t t t w w w w w w w t t t t t t t t t t t t t t t t t t g g g g g g t t t t t t t t t a
a t t t t t t t t w w w w w w w t t t t t t t t t t t t t t t t t t g g g g g g t t t t t t t t t a
a t t t t t t t t t w w w w w t t t t t t t t t t t t t t t t t t t g g g g g g t t t t t t t t t a
a t t t t t t t t t t t s s t t t t t t t t t t t t t t t t t t t t g g g g g g t t t t t t t t t a
a s s s s s s s s s s s s s s s s s s s s s s s s s s s s s s s s s s s s s s s s s s s s s s s s a
a t t t t t t t t t t t t t t t t t t s s t t t t t t t t t t t t t t t s s t t t t t t t t t t t a
a t t t t t t t t t t t t t t t t t t s s t t t t t t t t t t t t t t t s s t t t t t t t t t t t a
a t t t t t t t t t t t t t t t t t t s s t t t t t t t t t t t t t t t s s t t t t t t t t t t t a
a t t t t t t t t t t t t t t t t t t s s t t t t t t t t t t t t t t t s s t t t t t t t t t t t a
a t t t t t t t t t t t t t t t t t t s s t t t t t t t t t t t t t t t s s t t t t t t t t t t t a
a t t t t t a a a a a a a a t t t t t s s t t t t t t t t t t t t t t t s s t t t t t t t t t t t a
a t t t t t a e e e e e e a t t t t t s s t t t t t t t t t t t t t t t s s t t t t t t t t t t t a
a t t t t t a e e e e e e a t t t t t s s t t t t t t t t t t t t t t t s s t t t t t t t t t t t a
a t t t t t a e e e e e e a t t t t t s s t t t t t t t t t t t t t t t s s t t t t t t t t t t t a
a t t t t t a a g a a a a a t t t t t s t t t t t t t t t t t t t t t t s s t t t t t t t t t t t a
a t t t t t t t g t t t t t t t g g g g g g g t t t t t t t t t t t t t s s t t t t t t t t t t t a
a t t t t t t t g t t t t t t t g g g g g g g t t t t t t t t t t t t t s s t t t t t t t t t t t a
a t t t t t t t g t t t t t t g g g g g g g g g t t t t s s s s s s s s s s t t t t t t t t t t t a
a t t t t t t t g t t t t t t g g g g g g g g g t t t t s s t t t t t t s s t t t t t t t t t t t a
a t t t t t t t g t t t t t t t g g g g g g g t t t t t s s t t t t t t s s t t t t t t t t t t t a
a t t t t t t t g g g g g g g g g g g g g g t t t t t w w w w t t t t t s s t t t t t t t t t t t a
a t t t t t t t t t t t t t t t t t t t t t t t t t w w w w w w t t t t s s t t t t t t t t t t t a
a t t t t t t t t t t t t t t t t t t t t t t t t t w w w w w w t t t t s s t t t t t t t t t t t a
a t t t t t t t t t t t t t t t t t t t t t t t t t t w w w w t t t t t s s t t t t t t t t t t t a
a t t t t t t t t t t t t t t t t t t t t t t t t t t t w w t t t t t t s s t t t t t t t t t t t a
a t t t t t t t t t t t t t t t t t t t t t t t t t t t t t t t t t t t s s t t t t t t t t t t t a
a t t t t t t t t t t t t t t t g g g g g g g t t t t t t t t t t t t t s s t t t t t t t t t t t a
a t t t t t t t t t t t t t t t g g g g g g g s s s s s s s s s s s s s s s t t t t t t t t t t t a
a t t t t t t t t t t t t t t t g g g g g g g t t t t t t t t t t t t t s s t t t t t t t t t t t a
a t t t t t t t t t t t t t t t g g g g g g g t t t t t t t t t t t t t s s t t t t t t t t t t t a
a t t t t t t t t t t t t t t t t t t t t t t t t t t t t t t t t t t t s s t t t t t t t t t t t a
a t t t t t t t t t t t t t t t t t t t t t t t t t t t t t t t t t t t s s t t t t t t t t t t t a
a t t t t t t t t t t t t t t t t t t t t t t t t t t t t t t g g g g g g s t t t t t t t t t t t a
a t t t t t t t t t t t t t t t t t t t t t t t t t t t t t g g g g g g g g t t t t t t t t t t t a
a t t t t t t t t t t t t t t t t t t t t t t t t t t t t t g g g g g g g g t t t t t t t t t t t a
a t t t t t t t t t t t t t t t t t t t t t t t t t t t t t t g g g g g g g g t t t t t t t t t t a
a t t t t t t t t t t t t t t t t t t t t t t t t t t t t t t t g g g g g g g t t t t t t t t t t a
a t t t t t t t t t t t t t t t t t t t t t t t t t t t t t t t t g g g g g g t t t t t t t t t t a
a t t t t t t t t t t t t t t t t t t t t t t t t t t t t t t t t t t t t t t t t t t t t t t t t a
a t t t t t t t t t t t t t t t t t t t t t t t t t t t t t t t t t t t t t t t t t t t t t t t t a
a t t t t t t t t t t t t t t t t t t t t t t t t t t t t t t t t t t t t t t t t t t t t t t t t a
a t t t t t t t t t t t t t t t t t t t t t t t t t t t t t t t t t t t t t t t t t t t t t t t t a
a t t t t t t t t t t t t t t t t t t t t t t t t t t t t t t t t t t t t t t t t t t t t t t t t a
a t t t t t t t t t t t t t t t t t t t t t t t t t t t t t t t t t t t t t t t t t t t t t t t t a
a t t t t t t t t t t t t t t t t t t t t t t t t t t t t t t t t t t t t t t t t t t t t t t t t a
a g a a a a a a a a a a a a a a a g a a a a a a a a a a a a a a a g a a a a a a a a a a a a a a a a